111111111111111111111
100000000010000000001
100000000010000000001
100000000010000000001
100000000010000000001
100000000010000000001
100000000010000000001
100000000010000000001
100000000010000000001
100000034410000000001
100000000010000000001
100000000010000000001
100000000010000000001
100000000010000000001
100000000010000000001
100000000010000000001
100000000010000000001
100000000010000000001
100000000010000000001
100000000010000000001
111111111111111111111