111111111111111111111
100000000010000000001
100000000010000000001
100001000010000100001
100001000010000100001
100001000010000100001
100001000010000100001
100001000010000100001
100001000010000100001
100000000010000000001
100000000344000000001
100000000010000000001
100001000010000100001
100001000010000100001
100001000010000100001
100001000010000100001
100001000010000100001
100001000010000100001
100000000010000000001
100000000010000000001
111111111111111111111