211111111111111111112
100000000010000000001
100000000010000000001
100000000010000000001
100000000010000000001
100000000010000000001
100000000010000000001
100000000010000000001
100000000010000000001
100000034410000000001
100000000010000000001
100000000010000000001
100000000010000000001
100000000010000000001
100000000010000000001
100000000010000000001
100000000010000000001
100000000010000000001
100000000010000000001
100000000010000000001
211111111111111111112